Luís|Gonçalves|Brazil
Leonie|Köhler|Germany
François|Tremblay|Canada
František|Wichterlová|Czech Republic
Helena|Holý|Czech Republic
Eduardo|Martins|Brazil
Alexandre|Rocha|Brazil
Roberto|Almeida|Brazil
Fernanda|Ramos|Brazil
Mark|Philips|Canada
Jennifer|Peterson|Canada
Frank|Harris|USA
Jack|Smith|USA
Michelle|Brooks|USA
Tim|Goyer|USA
Dan|Miller|USA
Kathy|Chase|USA
Heather|Leacock|USA
John|Gordon|USA
Frank|Ralston|USA
Victor|Stevens|USA
Richard|Cunningham|USA
Patrick|Gray|USA
Julia|Barnett|USA
Robert|Brown|Canada
Edward|Francis|Canada
Martha|Silk|Canada
Aaron|Mitchell|Canada
Ellie|Sullivan|Canada
João|Fernandes|Portugal
Madalena|Sampaio|Portugal
Hannah|Schneider|Germany
Fynn|Zimmermann|Germany
Niklas|Schröder|Germany
Camille|Bernard|France
Dominique|Lefebvre|France
Marc|Dubois|France
Wyatt|Girard|France
Isabelle|Mercier|France
Emma|Jones|United Kingdom
Phil|Hughes|United Kingdom
Steve|Murray|United Kingdom
Manoj|Pareek|India
Puja|Srivastava|India
